LANGUAGE=English

FILE=File
EDIT=Edit
VIEW=View
TOOLS=Tools
HELP=Help

NEWBOT=New Bot
CLOSEBOT=Close Bot
HIDEBOT=Hide
ADDSCRIPT=Add Script
RUNSCRIPT=Run Script
RESUMESCRIPT=Resume Script
STOPSCRIPT=Stop Script
PAUSESCRIPT=Pause Script
SAVESCREENSHOT=Screenshot
EXIT=Exit

ACCOUNTS=Accounts
FORCEINPUT=Force Input
DISABLEANTIRANDOMS=Disable Randoms
DISABLEAUTOLOGIN=Disable Login
DISABLEADS=Disable advertisements
DISABLECONFIRMATIONS=Disable confirmations
LESSCPU=Less CPU
DISABLECANVAS=Disable Canvas
EXTDVIEWS=Extended views
AUTOSHUTDOWN=Shutdown (mins):
ALLOWALLHOSTS=Allow untrusted connections

HIDETOOLBAR=Hide Toolbar
ALLDEBUGGING=All Debugging

OPTIONS=Options
LICENSES=Licenses

SITE=Site
PROJECT=Project
LICENSE=License
ABOUT=About

TABDEFAULTTEXT=Bot
